1111111111111
1001000000001
1P000000011C1
100010E000101
1111111111110