111111111111111111
1P100C000000000001
101000000000000001
1E1011111111111111
111111111111111111